###########################
#                         #
#.# # #####   ##### # #.# #
#.# # # # 1234  # # # #.# #
#.#   # #       # #   #.# #
#.# # ############# # #.# #
#.# #               # #.# #
#.# ######## ######## #.# #
#           C             #
###########################
